12:12
3 0 0 0 0 0 0 0 2 53 0 0
0 0 0 0 0 0 0 0 2 0 0 0
2 2 2 2 0 0 0 2 2 18 0 0
0 0 0 6 2 0 0 0 0 0 0 0
0 0 0 0 2 0 0 0 0 0 0 0
169 0 0 4 4 0 0 0 2 2 2 2
0 0 0 0 2 0 0 0 2 2 2 2
0 0 21 53 2 2 0 0 0 0 0 2
2 18 18 18 2 0 0 0 0 0 0 0
0 0 0 53 2 2 2 4 2 2 0 153
0 0 0 18 2 2 0 0 0 2 0 18
153 0 85 8 18 2 0 0 85 2 0 18
