12,12
18 0 0 0 0 4 0 0 0 0 0 18
0 0 0 6 0 0 0 0 0 0 0 0
25 0 0 0 0 0 0 0 0 0 0 0
0 0 0 18 18 4 18 18 13 0 0 0
0 0 0 18 14 0 14 18 0 0 0 0
0 0 0 0 0 3 0 0 0 0 0 0
0 0 0 18 14 0 14 18 0 0 0 0
0 0 0 18 18 0 18 18 0 0 0 0
0 13 0 0 0 0 0 0 0 0 0 0
0 0 0 0 0 0 0 0 0 0 0 0
0 0 0 0 13 0 0 0 0 13 0 0
18 0 0 4 0 0 0 0 4 0 0 18

