12,12
57 3 0 0 0 0 0 11 50 50 11 4
34 34 34 0 0 0 0 11 50 50 11 0
4 0 34 0 34 0 0 11 50 50 11 0
18 6 34 0 34 0 0 11 50 50 11 0
0 0 0 0 0 0 0 11 50 50 11 0
34 34 34 0 0 0 0 11 18 18 11 0
34 4 34 0 0 0 0 0 0 0 0 0
1 6 34 34 34 0 34 0 6 0 0 34
34 0 0 0 0 0 0 34 0 0 0 34
34 34 34 34 0 0 0 34 34 0 0 34
34 4 6 0 0 0 0 0 0 4 34 34
34 34 34 18 4 18 0 34 34 0 6 4
