12:12
2 0 0 0 0 0 0 18 0 17 18 18
0 0 2 0 2 0 2 0 4 0 0 0
0 6 0 0 6 0 0 0 4 0 6 0
0 2 0 2 0 2 0 0 4 0 0 0
0 0 6 0 0 0 6 0 2 2 2 2
0 0 2 0 2 0 2 0 2 0 0 53
0 0 0 0 0 0 0 0 2 0 137 0
18 18 18 18 0 0 0 0 2 0 0 0
0 0 0 0 4 0 0 0 2 85 0 2
0 0 0 0 18 0 0 0 2 0 0 0
0 137 0 0 18 0 0 0 2 0 137 0
0 0 0 0 2 2 2 2 2 0 0 21
