12:12
0 0 18 0 0 18 0 0 18 18 18 18
18 0 0 0 0 0 0 0 0 0 0 18
0 0 0 0 0 0 0 0 0 0 0 18
0 0 18 18 18 18 18 18 18 18 0 18
0 2 0 0 0 4 0 0 0 18 0 153
137 0 0 0 2 53 2 0 0 18 18 18
0 2 0 2 0 2 0 2 0 2 0 2
0 4 0 0 4 0 0 4 0 0 0 0
0 2 0 2 0 2 0 2 0 2 0 2
0 0 4 0 6 0 0 0 6 0 4 0
2 4 2 0 2 0 2 0 2 0 2 0
0 4 0 0 0 1 0 0 0 0 0 0
