12,12
0 0 0 0 0 0 0 0 34 4 0 0
0 0 0 0 0 0 0 0 34 0 0 0
0 34 34 34 0 0 0 34 34 18 0 0
0 0 0 0 34 0 0 0 0 0 0 0
0 0 0 0 0 0 0 0 0 0 0 0
3 0 0 0 0 0 0 0 34 34 34 34
0 0 0 0 0 0 0 0 34 34 34 34
4 0 0 0 34 34 0 0 0 0 0
4 0 0 0 0 34 0 0 0 0 0 0
34 34 18 0 0 0 34 34 4 34 34 0
4 0 0 0 0 0 34 0 0 0 34 0
4 34 18 0 0 0 34 0 0 25 34 0
