12:12
18 18 18 18 18 18 18 18 18 18 18 18
18 6 0 0 0 0 53 18 0 0 0 0
18 0 0 0 0 0 85 18 0 18 0 18
18 18 18 0 0 18 18 18 0 18 0 0
0 0 0 4 4 0 0 0 0 18 0 41
0 0 0 0 0 0 0 0 0 18 18 18
0 0 0 0 18 18 18 18 0 0 0 0
0 18 0 18 2 2 2 18 0 0 0 0 
18 18 4 4 18 18 18 2 0 0 0 0
6 0 0 0 0 0 6 2 0 18 0 137
0 0 0 0 0 0 0 2 0 18 18 18
9 0 0 0 0 0 8 2 0 18 18 18
