12:12
2 3 0 0 0 0 0 18 8 0 18 4
18 18 18 0 0 0 0 18 0 0 18 0
4 0 18 0 18 0 0 18 0 0 18 0
18 6 18 0 18 0 0 18 0 0 18 0
0 0 0 0 0 0 0 18 0 0 18 0
18 18 18 0 0 0 0 18 4 4 4 0
18 4 18 0 0 0 0 0 0 0 153 0
0 6 18 18 18 0 18 0 6 0 0 18
0 0 0 0 0 0 0 0 18 0 0 18
0 18 18 18 0 0 0 18 0 0 0 18
0 4 6 0 0 0 0 0 4 0 153 18
25 0 0 18 4 0 0 18 18 0 6 4
