12,12
3 0 0 0 0 0 0 0 0 0 0 0
34 34 34 0 18 4 18 18 18 18 0 0
0 0 0 0 18 0 4 4 8 18 0 0
0 0 0 0 18 0 4 6 0 18 6 0
34 0 0 0 18 0 34 34 0 18 0 0
0 0 0 0 18 0 0 0 0 18 0 0
0 0 13 0 0 0 0 0 0 0 0 0
34 34 34 0 0 0 0 0 0 13 0 0
34 34 34 0 0 0 0 0 0 0 0 0
0 0 0 0 18 18 0 0 34 34 34 0
18 18 18 18 18 0 0 0 0 0 0 0
26 0 6 0 4 0 0 0 0 0 6 0

