12:12
18 18 18 18 0 0 0 18 2 0 0 153
18 3 0 0 0 0 0 18 0 0 0 0
18 2 2 0 0 0 0 18 18 0 0 0
0 85 2 0 0 0 0 0 0 0 18 18
169 0 2 2 2 0 0 0 0 18 18 18
0 0 2 2 2 0 0 0 0 0 18 18
18 18 18 18 18 0 0 0 0 0 2 2
0 0 4 0 0 18 0 0 0 0 0 2
0 0 4 0 0 18 0 0 0 0 0 2
0 0 18 0 0 18 0 0 0 0 0 2
0 0 18 0 6 18 0 0 0 0 0 2
153 0 18 8 0 18 0 0 0 0 0 2
